# punctuation
TildeToken="~"
ExclamationToken="!"
DollarToken="$"
PercentToken="%"
CaretToken="^"
AmpersandToken="&"
AsteriskToken="*"
OpenParenToken="("
CloseParenToken=")"
MinusToken="-"
PlusToken="+"
EqualsToken="="
OpenBraceToken="{"
CloseBraceToken="}"
OpenBracketToken="["
CloseBracketToken="]"
BarToken="|"
BackslashToken="\\"
ColonToken=":"
SemicolonToken=";"
DoubleQuoteToken="\"\""
SingleQuoteToken="\""
LessThanToken="<"
CommaToken=","
GreaterThanToken=">"
DotToken="."
QuestionToken="?"
HashToken="#"
SlashToken="/"
DotDotToken=".."

# additional xml tokens
SlashGreaterThanToken="/>"
LessThanSlashToken="</"
XmlCommentStartToken="<!--"
XmlCommentEndToken="-->"
XmlCDataStartToken="<![CDATA["
XmlCDataEndToken="]]>"
XmlProcessingInstructionStartToken="<?"
XmlProcessingInstructionEndToken="?>"

# compound punctuation
BarBarToken="||"
AmpersandAmpersandToken="&&"
MinusMinusToken="--"
PlusPlusToken="++"
ColonColonToken="::"
QuestionQuestionToken="??"
MinusGreaterThanToken="->"
ExclamationEqualsToken="!="
EqualsEqualsToken="=="
EqualsGreaterThanToken="=>"
LessThanEqualsToken="<="
LessThanLessThanToken="<<"
LessThanLessThanEqualsToken="<<="
GreaterThanEqualsToken=">="
GreaterThanGreaterThanToken=">>"
GreaterThanGreaterThanEqualsToken=">>="
SlashEqualsToken="/="
AsteriskEqualsToken="*="
BarEqualsToken="|="
AmpersandEqualsToken="&="
PlusEqualsToken="+="
MinusEqualsToken="-="
CaretEqualsToken="^="
PercentEqualsToken="%="
QuestionQuestionEqualsToken="??="

# keywords
BoolKeyword="bool"
ByteKeyword="byte"
SByteKeyword="sbyte"
ShortKeyword="short"
UShortKeyword="ushort"
IntKeyword="int"
UIntKeyword="uint"
LongKeyword="long"
ULongKeyword="ulong"
DoubleKeyword="double"
FloatKeyword="float"
DecimalKeyword="decimal"
StringKeyword="string"
CharKeyword="char"
VoidKeyword="void"
ObjectKeyword="object"
TypeOfKeyword="typeof"
SizeOfKeyword="sizeof"
NullKeyword="null"
TrueKeyword="true"
FalseKeyword="false"
IfKeyword="if"
ElseKeyword="else"
WhileKeyword="while"
ForKeyword="for"
ForEachKeyword="foreach"
DoKeyword="do"
SwitchKeyword="switch"
CaseKeyword="case"
DefaultKeyword="default"
TryKeyword="try"
CatchKeyword="catch"
FinallyKeyword="finally"
LockKeyword="lock"
GotoKeyword="goto"
BreakKeyword="break"
ContinueKeyword="continue"
ReturnKeyword="return"
ThrowKeyword="throw"
PublicKeyword="public"
PrivateKeyword="private"
InternalKeyword="internal"
ProtectedKeyword="protected"
StaticKeyword="static"
ReadOnlyKeyword="readonly"
SealedKeyword="sealed"
ConstKeyword="const"
FixedKeyword="fixed"
StackAllocKeyword="stackalloc"
VolatileKeyword="volatile"
NewKeyword="new"
OverrideKeyword="override"
AbstractKeyword="abstract"
VirtualKeyword="virtual"
EventKeyword="event"
ExternKeyword="extern"
RefKeyword="ref"
OutKeyword="out"
InKeyword="in"
IsKeyword="is"
AsKeyword="as"
ParamsKeyword="params"
ThisKeyword="this"
BaseKeyword="base"
NamespaceKeyword="namespace"
UsingKeyword="using"
ClassKeyword="class"
StructKeyword="struct"
InterfaceKeyword="interface"
EnumKeyword="enum"
DelegateKeyword="delegate"
CheckedKeyword="checked"
UncheckedKeyword="unchecked"
UnsafeKeyword="unsafe"
OperatorKeyword="operator"
ExplicitKeyword="explicit"
ImplicitKeyword="implicit"

# contextual keywords
YieldKeyword="yield"
PartialKeyword="partial"
AliasKeyword="alias"
GlobalKeyword="global"
AssemblyKeyword="assembly"
ModuleKeyword="module"
TypeKeyword="type"
FieldKeyword="field"
MethodKeyword="method"
ParamKeyword="param"
PropertyKeyword="property"
TypeVarKeyword="typevar"
GetKeyword="get"
SetKeyword="set"
AddKeyword="add"
RemoveKeyword="remove"
WhereKeyword="where"
FromKeyword="from"
GroupKeyword="group"
JoinKeyword="join"
IntoKeyword="into"
LetKeyword="let"
ByKeyword="by"
SelectKeyword="select"
OrderByKeyword="orderby"
OnKeyword="on"
EqualsKeyword="equals"
AscendingKeyword="ascending"
DescendingKeyword="descending"
NameOfKeyword="nameof"
AsyncKeyword="async"
AwaitKeyword="await"
WhenKeyword="when"

# additional preprocessor keywords
ElifKeyword="elif"
EndIfKeyword="endif"
RegionKeyword="region"
EndRegionKeyword="endregion"
DefineKeyword="define"
UndefKeyword="undef"
WarningKeyword="warning"
ErrorKeyword="error"
LineKeyword="line"
PragmaKeyword="pragma"
HiddenKeyword="hidden"
ChecksumKeyword="checksum"
DisableKeyword="disable"
RestoreKeyword="restore"
ReferenceKeyword="r"

InterpolatedStringStartToken="$\""
InterpolatedStringEndToken="\""
InterpolatedVerbatimStringStartTokenAt="$@\""
InterpolatedVerbatimStringStartTokenDollar="@$\""

# additional preprocessor keywords (continued)
LoadKeyword="load"
NullableKeyword="nullable"
EnableKeyword="enable"
SafeOnlyKeyword="safeonly"

# other
VarKeyword="var"
UnderscoreToken="_"
